wwwwwwwwwwwwwwwwwwwwwwwwwwwwwwwwwwwwwwwwwwwwwwww
wh.............................w..............gw
w.............................................gw
wA.............................w..............gw
w.............................................gw
wh.............................w..............gw
w.............................................gw
wh.............................w..............gw
wwwwwwwwwwwwwwwwwwwwwwwwwwwwwwwwwwwwwwwwwwwwwwww