wwwwwwwwwwwwwwwwwwwwwwwwwwwwwwwwwwwwwwwwwwwwwwww
w.............................................gw
w.............................................gw
w.............................................gw
w.....wwwww.wwwww.wwwwww......................gw
wh.....................w......................gw
wh.....................w......................gw
wA.....................w......................gw
wwwwwwwwwwwwwwwwwwwwwwwwwwwwwwwwwwwwwwwwwwwwwwww