wwwwwwwwwwwwwwwwwwwwwwwwwwwwwwwwwwwwwwwwwwwwwwww
wA.............ww..............w..............gw
w.............................................gw
wh.............ww..............w..............gw
w.............................................gw
wh.............ww..............w..............gw
w.............................................gw
wh.............ww..............w..............gw
wwwwwwwwwwwwwwwwwwwwwwwwwwwwwwwwwwwwwwwwwwwwwwww