wwwwwwwwwwwwwwwwwwwwwwwwwwwwwwwwwwwwwwwwwwwwwwww
wh.............ww..............w..............gw
w.............................................gw
wh.............ww..............w..............gw
w.............................................gw
wh.............ww..............w..............gw
w.............................................gw
wA.............ww..............w..............gw
wwwwwwwwwwwwwwwwwwwwwwwwwwwwwwwwwwwwwwwwwwwwwwww